         ____________________________________________________________________________________________
         |                                                                                          |
         |                                                                                          |
         |                                                                                          |
_________|                                                                                          |
                                                                                                    |
                                                                                                    |
                                                                                                    |
_________                                                                                           |
         |                                                                                          |
         |                                                                                          |
         |                                                                                          |
         |                                                                                          |
         |                                                                                          |
         |                                                                                          |
         |                                                                                          |
         |                                                                                          |
         |                                                                                          |
         |                                                                                          |
_________                                                                                           |
                                                                                                    |
                                                                                                    |
                                                                                                    |
_________                                                                                           |
         |                                                                                          |
         |                                                                                          |
         |                                                                                          |
         ____________________________________________________________________________________________